20 12
0 0
0 0 0 0 0 0 0 0 0 0 0 0 0 0 0 0 0 0 0 0
0 0 0 0 0 0 0 0 0 0 0 0 0 0 0 0 0 0 0 0
0 0 0 0 0 0 0 0 0 0 0 0 0 0 0 0 0 0 0 0
0 1 0 0 0 0 0 0 1 0 0 0 0 0 0 0 0 0 0 0
0 1 0 0 0 0 0 0 1 0 0 0 0 0 0 0 1 0 0 0
0 1 0 0 0 0 2 1 1 0 0 2 3 0 0 0 1 0 0 0
0 1 0 0 0 0 4 1 1 1 1 1 1 3 0 0 1 0 0 0
2 1 1 1 3 0 0 0 1 1 1 1 1 1 1 1 1 1 1 1
1 0 0 0 1 0 0 0 1 0 0 4 1 5 0 0 0 0 0 0
1 0 0 0 1 1 1 1 5 0 0 0 0 0 0 0 0 0 0 0
1 0 0 0 1 0 0 0 0 0 0 0 0 0 0 0 0 0 0 0
4 1 1 1 5 0 0 0 0 0 0 0 0 0 0 0 0 0 0 0